10 10
0 0 0 0 0 3 3 3 3 2
0 0 0 0 0 3 3 3 3 2
1 1 0 0 0 0 3 3 3 2
1 1 2 2 0 0 4 4 4 2
1 1 2 2 0 0 4 4 4 2
1 1 2 2 2 4 4 4 4 2
1 1 2 2 2 4 4 4 4 2
1 1 0 0 0 4 4 1 1 1
1 1 2 2 0 4 4 1 1 1
3 3 0 0 0 4 4 1 1 1