6 6 6 6 0 3 3 3 3 2
0 0 0 0 0 3 3 3 3 2
1 1 0 0 0 0 3 3 3 2
1 1 2 2 0 0 4 4 4 2
1 1 2 2 0 0 4 4 4 2
1 1 2 2 2 4 4 4 4 2
1 1 2 2 2 4 4 4 4 2
1 1 0 0 0 4 4 5 5 5
1 1 2 2 0 4 4 5 5 5
3 3 6 6 6 4 4 5 5 5